````````````````*`````````````````````````````````
```````````````*``````````````````````````````````
``````````````*```````````````````````````````````
`````````````*````````````````````````````````````
``````````````````````````````````````````````````
``````````````````````````````````````````````````
``````````````````````````````````````````````````
``````````*```````````````````````````````````````
`````````*````````````````````````````````````````
```````**`````````````````````````````````````````
``````*```````````````````````````````````````````
******````````````````````````````````````````````
``````````````````````````````````````````````````
``````````````````````````````````````````````````
```^^^^^^^^```````````````````````````````````````
`^^^^^^^^^^^^`````````````````````````````````````
^^^^^^^^^^^^^^```````````````````~.~...~~.`~.~~.``
^^^^^^^^^^^^^^^^`````````````````~~.~.~~.~.`.~.~..
^^^^^^^^^^^^^^^^`````````````````~~.~..~...~~~~.~.
^^^^^^^^^^^^^^^^^^```````````````~~.~.~~~.~..~..~~
^^^^^^^^^^^^^^^^^^^``````````````~.~.~...~..~...~.
^^^^^^^^^^^^^^^^^^^``````````````~~.~.~~.~.~~~~...
^^^^^^^^^^^^^^^^^^^^``````````````````````````````
^^^^^^^^^^^^^^^^^^^^^`````````````````````````````
^^^^^^^^^^^^^^^^^^^^^`````````````````````````````
^^^^^^^^^^^^^^^^^^^^^`````````````````````````````
^^^^^^^^^^^^^^^^^^^^``````````````````````````````
^^^^^^^^^^^^^^^^^^^```````````````````````````````
^^^^^^^^^^^^^^^^^^^```````````````````````````````
^^^^^^^^^^^^^^^^^^````````````````````````````````
`^^^^^^^^^^^^^^^``````````````````````````````````
```^^^^^^^^^^^^^``````````````````````````````````
`````^^^^^^^^^````````````````````````````````````
``````````````````````````````````````````````````
``````````````````````````````````````````````````
``````````````````````````````````````````````````
``````````````````````````````````````````````````
``````````````````````````````````````````````````
``````````````````````````````````````````````````
``````````````````````````````````````````````````
``````````````````````````````````````````````````
``````````````````````````````````````````````````
``````````````````````````````````````````````````
``````````````````````````````````````````````````
``````````````````````````````````````````````````
``````````````````````````````````````````````````
``````````````````````````````````````````````````
``````````````````````````````````````````````````
``````````````````````````````````````````````````
``````````````````````````````````````````````````